//MAP CONVERTED BY dmm2tgm.py THIS HEADER COMMENT PREVENTS RECONVERSION, DO NOT REMOVE
"ab" = (
/turf/template_noop,
/area/template_noop)
"ad" = (
/turf/closed/wall/r_wall,
/area/engine/engineering)
"ag" = (
/obj/structure/stairs/east,
/obj/structure/railing{
	dir = 6
	},
/obj/effect/turf_decal/tile/yellow{
	dir = 1
	},
/turf/open/floor/plasteel/dark,
/area/engine/engineering)
"ao" = (
/obj/structure/stairs/west,
/obj/structure/railing{
	dir = 10
	},
/obj/effect/turf_decal/tile/yellow{
	dir = 4
	},
/turf/open/floor/plasteel/dark,
/area/engine/engineering)
"ar" = (
/obj/structure/sign/warning/hottemp,
/turf/closed/wall/r_wall,
/area/engine/engineering)
"as" = (
/obj/structure/stairs/west,
/obj/structure/railing,
/obj/effect/turf_decal/tile/yellow{
	dir = 4
	},
/turf/open/floor/plasteel/dark,
/area/engine/engineering)
"at" = (
/obj/machinery/atmospherics/pipe/heat_exchanging/simple{
	dir = 4
	},
/obj/structure/lattice/catwalk,
/turf/template_noop,
/area/space/nearstation)
"au" = (
/obj/machinery/atmospherics/components/trinary/filter/flipped{
	dir = 4
	},
/obj/effect/turf_decal/bot,
/turf/open/floor/plasteel/monofloor,
/area/engine/engineering)
"av" = (
/obj/machinery/atmospherics/pipe/multiz/supply/visible/layer4{
	color = "#0000ff";
	dir = 4;
	name = "Supply multi deck pipe adapter"
	},
/obj/effect/turf_decal/stripes/box,
/turf/open/floor/plating,
/area/engine/engineering)
"aw" = (
/obj/machinery/atmospherics/components/binary/pump{
	dir = 4
	},
/turf/closed/wall/r_wall,
/area/engine/supermatter)
"aF" = (
/obj/machinery/atmospherics/components/unary/vent_pump/on{
	dir = 1
	},
/obj/machinery/atmospherics/pipe/heat_exchanging/manifold{
	dir = 8
	},
/turf/open/floor/engine/airless,
/area/engine/supermatter)
"aH" = (
/obj/machinery/camera{
	c_tag = "Engineering Supermatter Aft";
	network = list("ss13","engine");
	pixel_x = 23
	},
/obj/effect/turf_decal/tile/yellow{
	dir = 4
	},
/obj/effect/turf_decal/tile/yellow{
	dir = 1
	},
/obj/machinery/light{
	dir = 1;
	pixel_y = 0
	},
/turf/open/floor/plasteel/dark,
/area/engine/engineering)
"aK" = (
/obj/machinery/airalarm{
	dir = 4;
	pixel_x = -23
	},
/obj/machinery/camera{
	c_tag = "Engineering Supermatter Port";
	dir = 4;
	network = list("ss13","engine")
	},
/obj/effect/turf_decal/tile/yellow{
	dir = 1
	},
/obj/machinery/light{
	dir = 1;
	pixel_y = 0
	},
/turf/open/floor/plasteel/dark,
/area/engine/engineering)
"aL" = (
/obj/effect/turf_decal/stripes/box,
/obj/structure/cable/multilayer/multiz,
/obj/effect/turf_decal/tile/yellow{
	dir = 4
	},
/obj/effect/turf_decal/tile/yellow{
	dir = 1
	},
/turf/open/floor/plasteel/dark,
/area/engine/engineering)
"aM" = (
/obj/machinery/atmospherics/pipe/heat_exchanging/simple{
	dir = 10
	},
/obj/structure/lattice,
/turf/template_noop,
/area/space/nearstation)
"aO" = (
/obj/effect/turf_decal/stripes/corner,
/turf/open/floor/plasteel/dark,
/area/engine/engineering)
"aP" = (
/obj/machinery/atmospherics/pipe/smart/manifold4w/cyan/visible{
	dir = 8
	},
/obj/machinery/meter,
/obj/effect/turf_decal/stripes/line,
/turf/open/floor/plasteel/dark,
/area/engine/engineering)
"aQ" = (
/obj/structure/table/reinforced,
/obj/item/storage/toolbox/mechanical,
/obj/item/flashlight,
/obj/item/pipe_dispenser,
/obj/effect/turf_decal/tile/yellow{
	dir = 1
	},
/turf/open/floor/plasteel/dark,
/area/engine/engineering)
"aR" = (
/obj/machinery/atmospherics/pipe/smart/manifold4w/orange/visible,
/obj/machinery/meter,
/obj/effect/turf_decal/stripes/line,
/turf/open/floor/plasteel/dark,
/area/engine/engineering)
"aS" = (
/obj/effect/turf_decal/stripes/corner{
	dir = 8
	},
/turf/open/floor/plasteel/dark,
/area/engine/engineering)
"aU" = (
/obj/structure/table/reinforced,
/obj/item/tank/internals/emergency_oxygen/engi{
	pixel_x = 5
	},
/obj/item/clothing/gloves/color/black,
/obj/item/clothing/glasses/meson/engine,
/obj/effect/turf_decal/tile/yellow{
	dir = 1
	},
/obj/machinery/light{
	dir = 1;
	pixel_y = 0
	},
/turf/open/floor/plasteel/dark,
/area/engine/engineering)
"aV" = (
/obj/effect/turf_decal/stripes/line{
	dir = 1
	},
/obj/effect/turf_decal/tile/yellow{
	dir = 4
	},
/obj/effect/turf_decal/tile/yellow{
	dir = 1
	},
/turf/open/floor/plasteel/dark,
/area/engine/engineering)
"aW" = (
/obj/structure/table/reinforced,
/obj/item/clothing/suit/radiation,
/obj/item/clothing/head/radiation,
/obj/item/clothing/glasses/meson,
/obj/item/geiger_counter,
/obj/item/geiger_counter,
/obj/effect/turf_decal/tile/yellow{
	dir = 4
	},
/turf/open/floor/plasteel/dark,
/area/engine/engineering)
"ba" = (
/obj/structure/table/reinforced,
/obj/item/clothing/suit/radiation,
/obj/item/clothing/head/radiation,
/obj/item/clothing/glasses/meson,
/obj/item/clothing/glasses/meson,
/obj/effect/turf_decal/tile/yellow{
	dir = 4
	},
/turf/open/floor/plasteel/dark,
/area/engine/engineering)
"bb" = (
/turf/closed/wall,
/area/engine/engineering)
"bc" = (
/obj/effect/turf_decal/tile/yellow{
	dir = 4
	},
/obj/machinery/light{
	dir = 1;
	pixel_y = 0
	},
/turf/open/floor/plasteel/dark,
/area/engine/engineering)
"bd" = (
/obj/machinery/firealarm{
	dir = 8;
	pixel_x = 24
	},
/obj/machinery/atmospherics/pipe/smart/manifold4w/supply/hidden/layer4{
	dir = 10
	},
/obj/effect/turf_decal/tile/yellow,
/turf/open/floor/plasteel/dark,
/area/engine/engineering)
"be" = (
/obj/machinery/atmospherics/pipe/heat_exchanging/simple{
	dir = 9
	},
/obj/machinery/atmospherics/pipe/heat_exchanging/simple{
	dir = 6
	},
/obj/structure/lattice,
/turf/template_noop,
/area/space/nearstation)
"bt" = (
/obj/structure/lattice/catwalk,
/obj/machinery/atmospherics/pipe/heat_exchanging/simple{
	dir = 4
	},
/turf/template_noop,
/area/space/nearstation)
"bv" = (
/obj/structure/cable,
/obj/machinery/power/generator,
/obj/effect/turf_decal/bot_white,
/turf/open/floor/engine,
/area/engine/engineering)
"by" = (
/obj/structure/cable,
/turf/open/floor/plasteel/dark,
/area/engine/engineering)
"bA" = (
/obj/machinery/atmospherics/pipe/smart/manifold4w/general/visible{
	dir = 4
	},
/obj/machinery/meter,
/obj/effect/turf_decal/tile/yellow{
	dir = 8
	},
/turf/open/floor/plasteel/dark,
/area/engine/engineering)
"bC" = (
/obj/machinery/atmospherics/components/binary/pump/on{
	dir = 8;
	name = "Cooling Loop to Gas"
	},
/turf/open/floor/plasteel/dark,
/area/engine/engineering)
"bE" = (
/obj/machinery/atmospherics/components/binary/pump/on{
	name = "Gas to Cooling Loop"
	},
/obj/effect/turf_decal/tile/yellow{
	dir = 8
	},
/obj/machinery/light{
	dir = 8
	},
/turf/open/floor/plasteel/dark,
/area/engine/engineering)
"bF" = (
/obj/effect/turf_decal/stripes/line{
	dir = 4
	},
/turf/open/floor/plasteel/dark,
/area/engine/engineering)
"bG" = (
/obj/machinery/atmospherics/components/binary/pump/on{
	dir = 1
	},
/turf/open/floor/engine,
/area/engine/engineering)
"bH" = (
/obj/structure/cable,
/obj/machinery/power/floodlight{
	anchored = 1
	},
/turf/open/floor/engine,
/area/engine/engineering)
"bI" = (
/obj/machinery/atmospherics/components/binary/pump{
	dir = 1
	},
/turf/open/floor/engine,
/area/engine/engineering)
"bJ" = (
/obj/effect/turf_decal/stripes/line{
	dir = 8
	},
/turf/open/floor/plasteel/dark,
/area/engine/engineering)
"bK" = (
/obj/structure/cable,
/obj/effect/turf_decal/stripes/line{
	dir = 8
	},
/turf/open/floor/plasteel/dark,
/area/engine/engineering)
"bN" = (
/turf/open/floor/plasteel/dark,
/area/engine/engineering)
"bS" = (
/obj/machinery/atmospherics/pipe/heat_exchanging/junction{
	dir = 8
	},
/turf/closed/wall/r_wall,
/area/engine/engineering)
"bZ" = (
/obj/machinery/atmospherics/pipe/smart/manifold4w/cyan/visible{
	dir = 8
	},
/obj/machinery/meter,
/obj/effect/turf_decal/stripes/line{
	dir = 1
	},
/turf/open/floor/plasteel/dark,
/area/engine/engineering)
"ca" = (
/obj/machinery/atmospherics/components/binary/pump{
	dir = 8
	},
/obj/effect/turf_decal/stripes/line{
	dir = 1
	},
/obj/effect/turf_decal/bot_red,
/turf/open/floor/plasteel/monofloor,
/area/engine/engineering)
"cb" = (
/obj/machinery/atmospherics/pipe/smart/manifold4w/orange/visible,
/obj/machinery/meter,
/obj/effect/turf_decal/stripes/line{
	dir = 1
	},
/turf/open/floor/plasteel/dark,
/area/engine/engineering)
"cf" = (
/obj/structure/cable,
/obj/effect/turf_decal/stripes/line,
/turf/open/floor/plasteel/dark,
/area/engine/engineering)
"ch" = (
/obj/machinery/atmospherics/components/trinary/filter{
	dir = 4
	},
/obj/effect/turf_decal/bot,
/turf/open/floor/plasteel/monofloor,
/area/engine/engineering)
"ci" = (
/obj/machinery/atmospherics/pipe/heat_exchanging/junction{
	dir = 4
	},
/turf/closed/wall/r_wall,
/area/engine/supermatter)
"cj" = (
/obj/machinery/atmospherics/pipe/heat_exchanging/simple{
	dir = 10
	},
/turf/closed/wall/r_wall,
/area/engine/supermatter)
"cm" = (
/obj/machinery/atmospherics/pipe/layer_manifold/general/hidden,
/obj/effect/turf_decal/tile/yellow{
	dir = 4
	},
/obj/machinery/camera{
	c_tag = "Engineering Supermatter Starboard";
	dir = 8;
	network = list("ss13","engine")
	},
/turf/open/floor/plasteel/dark,
/area/engine/engineering)
"cw" = (
/obj/structure/cable,
/turf/open/floor/engine,
/area/engine/engineering)
"cx" = (
/obj/machinery/atmospherics/components/unary/vent_pump/on{
	dir = 1
	},
/obj/machinery/atmospherics/pipe/heat_exchanging/manifold4w,
/turf/open/floor/engine/airless,
/area/engine/supermatter)
"cy" = (
/obj/machinery/atmospherics/pipe/smart/manifold4w/orange/visible,
/obj/machinery/atmospherics/pipe/heat_exchanging/simple{
	dir = 10
	},
/obj/machinery/meter,
/turf/open/floor/engine/airless,
/area/engine/supermatter)
"cB" = (
/obj/structure/cable,
/obj/machinery/atmospherics/pipe/smart/manifold4w/orange/visible,
/turf/open/floor/plasteel/dark,
/area/engine/engineering)
"cC" = (
/obj/machinery/atmospherics/components/unary/portables_connector/visible{
	dir = 1
	},
/obj/effect/turf_decal/box,
/turf/open/floor/plasteel/monofloor,
/area/engine/engineering)
"cD" = (
/obj/machinery/firealarm{
	dir = 8;
	pixel_x = 24
	},
/obj/effect/turf_decal/stripes/box,
/obj/machinery/atmospherics/pipe/multiz/orange/visible/layer1{
	dir = 1
	},
/turf/open/floor/plating,
/area/engine/engineering)
"cK" = (
/obj/machinery/atmospherics/components/binary/circulator/cold{
	dir = 4
	},
/obj/structure/cable,
/obj/effect/turf_decal/bot_white,
/turf/open/floor/engine,
/area/engine/engineering)
"cL" = (
/obj/machinery/atmospherics/components/binary/circulator/flipped{
	dir = 8
	},
/obj/structure/cable,
/obj/effect/turf_decal/bot_white,
/turf/open/floor/engine,
/area/engine/engineering)
"cM" = (
/obj/effect/turf_decal/tile/yellow{
	dir = 8
	},
/obj/machinery/light{
	dir = 8
	},
/turf/open/floor/plasteel/dark,
/area/engine/engineering)
"cP" = (
/obj/effect/turf_decal/stripes/box,
/obj/structure/cable/multilayer/multiz,
/obj/machinery/light{
	dir = 4
	},
/turf/open/floor/plating,
/area/engine/engineering)
"cQ" = (
/obj/machinery/atmospherics/pipe/multiz/scrubbers/visible/layer2{
	color = "#ff0000";
	dir = 4;
	name = "Scrubbers multi deck pipe adapter"
	},
/obj/effect/turf_decal/stripes/box,
/turf/open/floor/plating,
/area/engine/engineering)
"cT" = (
/obj/effect/turf_decal/tile/yellow{
	dir = 8
	},
/obj/machinery/atmospherics/pipe/smart/manifold4w/cyan/visible{
	dir = 8
	},
/turf/open/floor/plasteel/dark,
/area/engine/engineering)
"cU" = (
/obj/machinery/atmospherics/pipe/heat_exchanging/manifold{
	dir = 8
	},
/obj/effect/turf_decal/stripes/red/line{
	dir = 8
	},
/turf/open/floor/engine/airless,
/area/engine/supermatter)
"cV" = (
/obj/machinery/atmospherics/pipe/smart/manifold4w/orange/visible,
/obj/machinery/atmospherics/pipe/heat_exchanging/simple{
	dir = 6
	},
/turf/open/floor/engine/airless,
/area/engine/supermatter)
"cW" = (
/obj/machinery/atmospherics/components/unary/vent_pump/on{
	dir = 1
	},
/obj/machinery/atmospherics/pipe/heat_exchanging/manifold{
	dir = 4
	},
/turf/open/floor/engine/airless,
/area/engine/supermatter)
"cX" = (
/obj/machinery/portable_atmospherics/canister/nitrogen,
/obj/effect/turf_decal/box,
/obj/machinery/atmospherics/components/unary/portables_connector/visible{
	name = "output gas connector port"
	},
/turf/open/floor/plasteel/monofloor,
/area/engine/engineering)
"cY" = (
/obj/effect/turf_decal/box,
/obj/machinery/portable_atmospherics/canister/toxins,
/obj/machinery/atmospherics/components/unary/portables_connector/visible{
	name = "output gas connector port"
	},
/turf/open/floor/plasteel/monofloor,
/area/engine/engineering)
"cZ" = (
/obj/effect/turf_decal/tile/yellow{
	dir = 4
	},
/obj/machinery/atmospherics/pipe/smart/manifold4w/scrubbers/hidden/layer2{
	dir = 1
	},
/turf/open/floor/plasteel/dark,
/area/engine/engineering)
"da" = (
/obj/structure/stairs/east,
/obj/structure/railing,
/obj/effect/turf_decal/tile/yellow{
	dir = 1
	},
/turf/open/floor/plasteel/dark,
/area/engine/engineering)
"dd" = (
/obj/effect/turf_decal/tile/yellow{
	dir = 4
	},
/turf/open/floor/plasteel/dark,
/area/engine/engineering)
"de" = (
/turf/closed/wall/r_wall,
/area/maintenance/aft/upper)
"di" = (
/obj/structure/lattice/catwalk,
/obj/machinery/atmospherics/pipe/heat_exchanging/simple{
	dir = 6
	},
/turf/template_noop,
/area/space/nearstation)
"dj" = (
/obj/machinery/atmospherics/pipe/heat_exchanging/manifold{
	dir = 4
	},
/obj/machinery/atmospherics/components/unary/vent_scrubber/on,
/turf/open/floor/engine/airless,
/area/engine/supermatter)
"dk" = (
/obj/machinery/camera{
	c_tag = "Engineering Supermatter Port";
	dir = 4;
	network = list("ss13","engine")
	},
/obj/effect/turf_decal/tile/yellow{
	dir = 8
	},
/turf/open/floor/plasteel/dark,
/area/engine/engineering)
"dm" = (
/obj/machinery/atmospherics/pipe/smart/manifold4w/cyan/visible{
	dir = 8
	},
/obj/effect/turf_decal/tile/yellow{
	dir = 8
	},
/turf/open/floor/plasteel/dark,
/area/engine/engineering)
"do" = (
/obj/effect/turf_decal/stripes/corner{
	dir = 4
	},
/turf/open/floor/plasteel/dark,
/area/engine/engineering)
"dp" = (
/obj/effect/turf_decal/stripes/corner{
	dir = 1
	},
/turf/open/floor/plasteel/dark,
/area/engine/engineering)
"dq" = (
/obj/machinery/atmospherics/components/unary/portables_connector/visible{
	dir = 4
	},
/obj/effect/turf_decal/box,
/obj/machinery/portable_atmospherics/canister/oxygen,
/turf/open/floor/plasteel/monofloor,
/area/engine/engineering)
"dr" = (
/obj/effect/turf_decal/bot,
/obj/machinery/atmospherics/components/trinary/mixer/flipped{
	dir = 8
	},
/turf/open/floor/plasteel/monofloor,
/area/engine/engineering)
"ds" = (
/obj/machinery/atmospherics/components/binary/pump,
/turf/open/floor/plasteel/dark,
/area/engine/engineering)
"dt" = (
/obj/machinery/meter,
/obj/machinery/atmospherics/pipe/smart/manifold4w/orange/visible,
/obj/machinery/light{
	dir = 4
	},
/turf/open/floor/plasteel/dark,
/area/engine/engineering)
"dx" = (
/obj/machinery/atmospherics/pipe/heat_exchanging/simple{
	dir = 4
	},
/obj/structure/lattice,
/turf/template_noop,
/area/space/nearstation)
"dy" = (
/obj/machinery/atmospherics/pipe/heat_exchanging/simple{
	dir = 5
	},
/obj/machinery/atmospherics/pipe/smart/manifold4w/scrubbers/visible{
	dir = 4
	},
/turf/open/floor/engine/airless,
/area/engine/supermatter)
"dz" = (
/obj/machinery/atmospherics/pipe/heat_exchanging/manifold,
/obj/machinery/atmospherics/pipe/smart/manifold4w/scrubbers/visible{
	dir = 4
	},
/turf/open/floor/engine/airless,
/area/engine/supermatter)
"dA" = (
/obj/machinery/atmospherics/pipe/heat_exchanging/simple{
	dir = 9
	},
/obj/machinery/atmospherics/pipe/smart/manifold4w/scrubbers/visible{
	dir = 4
	},
/obj/machinery/meter,
/turf/open/floor/engine/airless,
/area/engine/supermatter)
"dF" = (
/obj/machinery/atmospherics/pipe/smart/manifold4w/cyan/visible{
	dir = 8
	},
/turf/open/floor/plasteel/dark,
/area/engine/engineering)
"dG" = (
/obj/machinery/atmospherics/components/binary/pump{
	dir = 4
	},
/obj/effect/turf_decal/bot_red,
/turf/open/floor/plasteel/monofloor,
/area/engine/engineering)
"dH" = (
/obj/machinery/atmospherics/components/binary/pump{
	dir = 4
	},
/turf/open/floor/plasteel/dark,
/area/engine/engineering)
"dM" = (
/obj/machinery/atmospherics/pipe/smart/manifold4w/orange/visible,
/obj/machinery/atmospherics/pipe/heat_exchanging/manifold4w,
/turf/open/floor/engine/airless,
/area/engine/supermatter)
"dO" = (
/obj/machinery/atmospherics/components/unary/thermomachine/freezer{
	dir = 1
	},
/obj/effect/turf_decal/bot_white,
/turf/open/floor/plasteel/monofloor,
/area/engine/engineering)
"dP" = (
/obj/machinery/computer/atmos_control/incinerator{
	dir = 8;
	name = "TEG Air Control"
	},
/turf/open/floor/plasteel/monofloor,
/area/engine/engineering)
"dQ" = (
/obj/machinery/button/ignition{
	id = "TEG"
	},
/turf/closed/wall/r_wall,
/area/engine/supermatter)
"dR" = (
/obj/machinery/atmospherics/pipe/heat_exchanging/manifold4w,
/obj/machinery/igniter{
	id = "TEG"
	},
/obj/machinery/air_sensor/atmos/incinerator_tank{
	name = "TEG chamber gas sensor"
	},
/turf/open/floor/engine/airless,
/area/engine/supermatter)
"dS" = (
/obj/machinery/atmospherics/pipe/heat_exchanging/manifold{
	dir = 4
	},
/obj/machinery/meter,
/turf/open/floor/engine/airless,
/area/engine/supermatter)
"dT" = (
/obj/machinery/atmospherics/components/binary/pump{
	dir = 8
	},
/obj/machinery/light{
	dir = 4
	},
/turf/open/floor/plasteel/dark,
/area/engine/engineering)
"dU" = (
/obj/machinery/light{
	pixel_y = 0
	},
/turf/open/floor/plasteel/dark,
/area/engine/engineering)
"dW" = (
/obj/machinery/door/firedoor,
/turf/open/floor/plasteel/dark,
/area/engine/engineering)
"dY" = (
/obj/machinery/portable_atmospherics/canister/oxygen,
/turf/open/floor/plasteel/dark,
/area/engine/engineering)
"dZ" = (
/obj/structure/chair/office/light{
	dir = 4
	},
/turf/open/floor/plasteel/dark,
/area/engine/engineering)
"ea" = (
/obj/effect/turf_decal/tile/yellow,
/obj/machinery/light{
	dir = 4
	},
/turf/open/floor/plasteel/dark,
/area/engine/engineering)
"eb" = (
/obj/machinery/portable_atmospherics/canister/oxygen,
/obj/machinery/light{
	dir = 4
	},
/turf/open/floor/plasteel/dark,
/area/engine/engineering)
"ec" = (
/obj/machinery/atmospherics/pipe/heat_exchanging/simple{
	dir = 4
	},
/obj/machinery/atmospherics/pipe/heat_exchanging/simple,
/obj/structure/lattice,
/turf/template_noop,
/area/space/nearstation)
"ef" = (
/obj/effect/turf_decal/tile/yellow,
/obj/machinery/camera{
	c_tag = "Engineering Supermatter Starboard";
	dir = 8;
	network = list("ss13","engine")
	},
/turf/open/floor/plasteel/dark,
/area/engine/engineering)
"eg" = (
/obj/effect/turf_decal/tile/yellow{
	dir = 8
	},
/turf/open/floor/plasteel/dark,
/area/engine/engineering)
"eh" = (
/obj/machinery/atmospherics/components/unary/thermomachine/heater,
/obj/effect/turf_decal/bot_white,
/turf/open/floor/plasteel/monofloor,
/area/engine/engineering)
"ei" = (
/obj/effect/turf_decal/stripes/line{
	dir = 4
	},
/obj/effect/turf_decal/tile/yellow,
/turf/open/floor/plasteel/dark,
/area/engine/engineering)
"ej" = (
/obj/machinery/airalarm/engine{
	dir = 8;
	pixel_x = 23;
	pixel_y = -32
	},
/obj/effect/turf_decal/stripes/line{
	dir = 4
	},
/obj/effect/turf_decal/caution{
	dir = 8
	},
/turf/open/floor/plasteel/dark,
/area/engine/engineering)
"ek" = (
/obj/structure/fans/tiny,
/obj/machinery/door/airlock/engineering/glass{
	name = "Engine Room";
	req_access_txt = "10"
	},
/obj/effect/turf_decal/stripes/full,
/turf/open/floor/engine/airless,
/area/engine/supermatter)
"eq" = (
/obj/structure/sign/warning/nosmoking,
/turf/closed/wall/r_wall,
/area/engine/engineering)
"er" = (
/obj/machinery/atmospherics/pipe/smart/manifold4w/orange/visible,
/turf/open/floor/plasteel/dark,
/area/engine/engineering)
"es" = (
/obj/structure/sign/warning/fire,
/turf/closed/wall/r_wall,
/area/engine/engineering)
"et" = (
/obj/machinery/atmospherics/pipe/smart/manifold4w/orange/visible,
/obj/machinery/meter,
/turf/open/floor/plasteel/dark,
/area/engine/engineering)
"ev" = (
/obj/effect/spawner/structure/window/plasma/reinforced,
/obj/machinery/atmospherics/pipe/smart/manifold4w/scrubbers/visible{
	dir = 10
	},
/turf/open/floor/plating,
/area/engine/engineering)
"ew" = (
/obj/machinery/atmospherics/pipe/smart/manifold4w/scrubbers/visible,
/turf/open/floor/plating/airless,
/area/engine/engineering)
"eA" = (
/obj/machinery/atmospherics/pipe/smart/manifold4w/orange/visible,
/obj/effect/spawner/structure/window/plasma/reinforced,
/turf/open/floor/plating,
/area/engine/supermatter)
"eC" = (
/obj/machinery/atmospherics/pipe/heat_exchanging/manifold4w,
/obj/machinery/atmospherics/components/unary/vent_scrubber/on,
/turf/open/floor/engine/airless,
/area/engine/supermatter)
"eD" = (
/obj/structure/lattice/catwalk,
/obj/machinery/atmospherics/pipe/heat_exchanging/simple{
	dir = 9
	},
/turf/template_noop,
/area/space/nearstation)
"eE" = (
/obj/machinery/atmospherics/components/unary/outlet_injector/atmos/engine_waste{
	dir = 8
	},
/turf/open/floor/plating/airless,
/area/engine/engineering)
"eG" = (
/obj/machinery/atmospherics/pipe/bridge_pipe/green/visible,
/obj/machinery/atmospherics/pipe/bridge_pipe/yellow/visible{
	dir = 4
	},
/turf/open/floor/plasteel/dark,
/area/engine/engineering)
"eH" = (
/obj/machinery/atmospherics/components/binary/pump{
	dir = 1
	},
/turf/open/floor/plasteel/dark,
/area/engine/engineering)
"eI" = (
/obj/machinery/camera{
	c_tag = "Engineering Supermatter Fore";
	dir = 1;
	network = list("ss13","engine");
	pixel_x = 23
	},
/obj/effect/turf_decal/tile/yellow{
	dir = 8
	},
/turf/open/floor/plasteel/dark,
/area/engine/engineering)
"eJ" = (
/obj/machinery/camera{
	c_tag = "Engineering Supermatter Fore";
	dir = 1;
	network = list("ss13","engine");
	pixel_x = 23
	},
/obj/effect/turf_decal/tile/yellow,
/turf/open/floor/plasteel/dark,
/area/engine/engineering)
"eK" = (
/obj/structure/lattice,
/obj/structure/grille,
/turf/template_noop,
/area/space/nearstation)
"eN" = (
/obj/machinery/atmospherics/components/unary/portables_connector/visible{
	dir = 4
	},
/obj/effect/turf_decal/box,
/obj/machinery/portable_atmospherics/canister/tier_2,
/turf/open/floor/plasteel/monofloor,
/area/engine/engineering)
"eO" = (
/obj/machinery/atmospherics/components/binary/pump{
	dir = 8
	},
/turf/open/floor/plasteel/dark,
/area/engine/engineering)
"eP" = (
/obj/effect/spawner/structure/window/plasma/reinforced,
/obj/machinery/atmospherics/pipe/smart/manifold4w/scrubbers/visible{
	dir = 4
	},
/turf/open/floor/plating,
/area/engine/supermatter)
"eV" = (
/obj/machinery/atmospherics/components/unary/portables_connector/visible{
	dir = 1
	},
/obj/effect/turf_decal/box,
/obj/machinery/portable_atmospherics/canister/nitrogen,
/turf/open/floor/plasteel/monofloor,
/area/engine/engineering)
"fb" = (
/turf/closed/wall/r_wall,
/area/engine/supermatter)
"fe" = (
/obj/effect/turf_decal/stripes/line,
/turf/open/floor/plasteel/dark,
/area/engine/engineering)
"fi" = (
/obj/machinery/portable_atmospherics/canister/nitrogen,
/obj/machinery/light{
	dir = 8
	},
/turf/open/floor/plasteel/dark,
/area/engine/engineering)
"fk" = (
/obj/structure/cable,
/obj/machinery/door/airlock/engineering/glass{
	name = "Engine Room";
	req_access_txt = "10"
	},
/obj/machinery/door/firedoor/border_only{
	dir = 1
	},
/obj/machinery/door/firedoor/border_only,
/turf/open/floor/plasteel/dark,
/area/engine/engineering)
"fm" = (
/obj/structure/lattice/catwalk,
/obj/machinery/atmospherics/pipe/heat_exchanging/simple{
	dir = 5
	},
/turf/template_noop,
/area/space/nearstation)
"fq" = (
/obj/machinery/portable_atmospherics/canister/nitrogen,
/turf/open/floor/plasteel/dark,
/area/engine/engineering)
"fr" = (
/obj/machinery/portable_atmospherics/canister/tier_2,
/turf/open/floor/plasteel/dark,
/area/engine/engineering)
"ft" = (
/obj/machinery/door/airlock/engineering/glass{
	name = "Engine Room";
	req_access_txt = "10"
	},
/obj/machinery/door/firedoor/border_only{
	dir = 1
	},
/obj/machinery/door/firedoor/border_only,
/turf/open/floor/plasteel/dark,
/area/engine/engineering)
"fu" = (
/obj/machinery/light{
	dir = 1
	},
/turf/open/floor/plasteel/dark,
/area/engine/engineering)
"fv" = (
/obj/effect/turf_decal/stripes/line{
	dir = 1
	},
/turf/open/floor/plasteel/dark,
/area/engine/engineering)
"gP" = (
/obj/machinery/camera{
	c_tag = "Engineering Supermatter Port";
	dir = 4;
	network = list("ss13","engine")
	},
/obj/effect/turf_decal/tile/yellow{
	dir = 8
	},
/obj/machinery/light{
	dir = 8
	},
/turf/open/floor/plasteel/dark,
/area/engine/engineering)
"lI" = (
/obj/machinery/door/airlock/maintenance{
	name = "Engineering Maintenance";
	req_access_txt = "10"
	},
/obj/machinery/door/firedoor/border_only{
	dir = 4
	},
/obj/machinery/door/firedoor/border_only{
	dir = 8
	},
/turf/open/floor/plating,
/area/engine/engineering)
"oi" = (
/obj/structure/lattice/catwalk,
/obj/machinery/atmospherics/pipe/heat_exchanging/simple{
	dir = 10
	},
/turf/template_noop,
/area/space/nearstation)
"tB" = (
/obj/effect/spawner/structure/window/plasma/reinforced,
/turf/open/floor/plating,
/area/engine/engineering)
"vJ" = (
/obj/effect/turf_decal/tile/yellow,
/turf/open/floor/plasteel/dark,
/area/engine/engineering)
"wC" = (
/obj/structure/lattice/catwalk,
/obj/structure/ladder,
/obj/machinery/atmospherics/pipe/heat_exchanging/simple{
	dir = 9
	},
/turf/template_noop,
/area/space/nearstation)
"AD" = (
/obj/machinery/atmospherics/pipe/heat_exchanging/simple{
	dir = 4
	},
/obj/structure/lattice,
/obj/machinery/atmospherics/pipe/heat_exchanging/simple,
/turf/template_noop,
/area/space/nearstation)
"Fw" = (
/obj/machinery/door/airlock/maintenance{
	name = "Engineering Maintenance";
	req_access_txt = "10"
	},
/obj/machinery/door/firedoor/border_only,
/obj/machinery/door/firedoor/border_only{
	dir = 1
	},
/turf/open/floor/plating,
/area/engine/engineering)
"FO" = (
/obj/effect/turf_decal/stripes/box,
/obj/structure/ladder,
/turf/open/floor/plating,
/area/maintenance/aft/upper)
"LF" = (
/obj/structure/lattice/catwalk,
/turf/template_noop,
/area/space/nearstation)

(1,1,1) = {"
ab
ab
ab
ab
ab
ab
ab
ab
ab
ab
ab
ab
ab
ab
ab
ab
ab
ab
ab
ab
ab
ab
ab
ab
ab
ab
"}
(2,1,1) = {"
ab
LF
di
fm
di
fm
di
fm
di
fm
di
fm
di
fm
di
fm
di
fm
di
fm
di
fm
di
fm
eK
ab
"}
(3,1,1) = {"
ab
di
ec
ec
ec
ec
ec
ec
ec
ec
ec
ec
ec
ec
ec
ec
ec
ec
ec
ec
ec
ec
ec
eD
eK
ab
"}
(4,1,1) = {"
ab
oi
ec
ec
ec
ec
ec
ec
ec
ec
ec
ec
ec
ec
ec
ec
ec
ec
ec
ec
ec
ec
ec
fm
eK
ab
"}
(5,1,1) = {"
ab
di
ec
ec
ec
ec
ec
ec
ec
ec
ec
ec
ec
ec
ec
ec
ec
ec
ec
ec
ec
ec
ec
eD
eK
ab
"}
(6,1,1) = {"
ab
oi
ec
ec
ec
ec
ec
ec
ec
ec
ec
ec
ec
ec
ec
ec
ec
ec
ec
ec
ec
ec
ec
fm
eK
ab
"}
(7,1,1) = {"
ab
di
ec
ec
ec
ec
ec
ec
ec
ec
ec
ec
ec
ec
ec
ec
ec
ec
ec
ec
ec
ec
ec
eD
eK
ab
"}
(8,1,1) = {"
ab
oi
ec
ec
ec
ec
ec
ec
ec
ec
ec
ec
ec
ec
ec
ec
ec
ec
ec
ec
ec
ec
ec
fm
eK
ab
"}
(9,1,1) = {"
ab
di
ec
ec
ec
ec
ec
ec
ec
ec
ec
ec
ec
ec
ec
ec
ec
ec
ec
ec
ec
ec
ec
eD
eK
ab
"}
(10,1,1) = {"
ab
oi
ec
ec
ec
ec
ec
ec
ec
ec
ec
ec
ec
ec
ec
ec
ec
ec
ec
ec
ec
ec
ec
fm
eK
ab
"}
(11,1,1) = {"
ab
LF
dx
aM
be
AD
AD
AD
AD
AD
AD
ec
ec
ec
ec
ec
ec
ec
ec
ec
ec
ec
ec
eD
eK
ab
"}
(12,1,1) = {"
ab
LF
at
LF
bt
oi
eD
oi
wC
oi
eD
oi
eD
oi
eD
oi
eD
oi
eD
oi
eD
oi
eD
LF
LF
ab
"}
(13,1,1) = {"
ab
ad
bS
tB
bS
ad
ad
tB
tB
tB
ad
ad
ad
ad
tB
tB
tB
ad
ad
ad
ad
ad
ad
ad
LF
ab
"}
(14,1,1) = {"
ad
ad
bA
eg
bA
bE
cT
dm
dm
eg
cM
eg
dk
cM
eg
eg
eg
gP
eg
eg
eg
cM
eg
ad
LF
ab
"}
(15,1,1) = {"
ad
aK
bC
bN
bN
bN
bN
bN
dF
bN
bN
bN
bN
bN
bN
ad
ad
ad
ad
bN
bN
bN
eg
ad
LF
ab
"}
(16,1,1) = {"
ad
da
au
ds
cC
bN
cX
ds
dF
dO
eh
er
eH
eV
bN
ad
fi
fq
ad
bN
bN
bN
eg
tB
LF
ab
"}
(17,1,1) = {"
ad
ag
dF
bN
bN
bN
bN
bN
dF
bN
bN
er
bN
bN
bN
ad
fq
fq
ad
bN
bN
bN
eg
tB
LF
ab
"}
(18,1,1) = {"
ad
aQ
au
ds
cC
bN
cX
ds
dF
dO
eh
er
eH
eV
bN
ad
fq
fq
ad
bN
bN
bN
eI
ad
LF
ab
"}
(19,1,1) = {"
es
aU
dF
aO
bF
bF
bF
do
dF
bN
bN
er
bN
bN
bN
ad
dW
dW
ad
bN
bN
bN
dU
ad
LF
ab
"}
(20,1,1) = {"
Fw
aV
dF
aP
bI
cK
bG
bZ
dF
bN
bN
er
bN
bN
dU
es
bN
dU
eq
fu
bN
bN
bN
tB
LF
ab
"}
(21,1,1) = {"
ar
aL
by
cf
cw
bv
bH
ca
dG
bN
bN
er
bN
bN
fe
fk
bN
bN
ft
fv
bN
eG
bN
tB
LF
ab
"}
(22,1,1) = {"
ad
aH
er
aR
bI
cL
bI
cb
er
er
er
er
bN
bN
bN
eq
dW
dW
es
bN
bN
bN
bN
tB
LF
ab
"}
(23,1,1) = {"
ad
aW
er
aS
bJ
bK
bJ
dp
bN
bN
bN
er
bN
bN
bN
ad
dY
fr
ad
bN
bN
bN
dU
ad
LF
ab
"}
(24,1,1) = {"
ad
ba
ch
ds
cC
by
bN
bN
dq
bN
bN
er
bN
bN
bN
ad
dY
fr
ad
bN
bN
bN
eJ
ad
LF
ab
"}
(25,1,1) = {"
ad
ao
er
bN
bN
by
bN
bN
dH
bN
bN
er
bN
bN
bN
ad
eb
fr
ad
bN
bN
bN
vJ
tB
LF
ab
"}
(26,1,1) = {"
ad
as
ch
ds
cC
by
cY
ds
dr
dZ
bN
et
eN
bN
bN
ad
ad
ad
ad
bN
bN
bN
vJ
tB
LF
ab
"}
(27,1,1) = {"
ad
bc
er
er
er
cB
er
dt
dH
dP
ej
dT
eO
vJ
vJ
ea
ef
ei
vJ
vJ
vJ
ea
vJ
ad
LF
ab
"}
(28,1,1) = {"
ad
ad
dd
cm
cD
cP
cZ
aw
eA
dQ
ek
ci
eP
fb
ad
ad
ad
lI
ad
ad
ev
ad
ad
ad
LF
ab
"}
(29,1,1) = {"
ab
ad
ad
ad
bb
ad
cQ
ci
cV
aF
cU
eC
dy
fb
LF
LF
de
FO
de
LF
ew
LF
LF
LF
LF
ab
"}
(30,1,1) = {"
ab
ab
ab
ab
ab
ad
av
cj
dM
cx
dR
eC
dz
fb
LF
LF
de
de
de
LF
eE
LF
ab
ab
ab
ab
"}
(31,1,1) = {"
ab
ab
ab
ab
ab
ad
bd
fb
cy
cW
dS
dj
dA
fb
LF
LF
LF
LF
LF
LF
LF
LF
ab
ab
ab
ab
"}
(32,1,1) = {"
ab
ab
ab
ab
ab
ad
ad
fb
fb
fb
fb
fb
fb
fb
ab
ab
ab
ab
ab
ab
ab
ab
ab
ab
ab
ab
"}
