//MAP CONVERTED BY dmm2tgm.py THIS HEADER COMMENT PREVENTS RECONVERSION, DO NOT REMOVE
"a" = (
/obj/machinery/computer/shuttle{
	dir = 4
	},
/obj/effect/turf_decal/stripes/line{
	dir = 9
	},
/turf/open/floor/mineral/titanium/yellow,
/area/shuttle/supply)
"b" = (
/turf/closed/wall/mineral/titanium,
/area/shuttle/supply)
"c" = (
/turf/open/floor/mineral/titanium/blue,
/area/shuttle/supply)
"d" = (
/obj/structure/chair/comfy/shuttle{
	dir = 1
	},
/obj/effect/turf_decal/stripes/line{
	dir = 1
	},
/obj/effect/decal/cleanable/dirt,
/turf/open/floor/mineral/titanium/yellow,
/area/shuttle/supply)
"e" = (
/obj/item/conv_printer,
/obj/item/export_scanner,
/obj/effect/decal/cleanable/dirt,
/turf/open/floor/mineral/titanium/yellow,
/area/shuttle/supply)
"f" = (
/obj/effect/decal/cleanable/dirt,
/turf/open/floor/mineral/titanium/blue,
/area/shuttle/supply)
"g" = (
/obj/machinery/conveyor{
	dir = 5;
	id = "Cargo_Shuttle_Conveyor";
	movedir = 4;
	name = "Cargo Shuttle conveyor belt"
	},
/obj/effect/turf_decal/stripes/line{
	dir = 8
	},
/obj/effect/turf_decal/bot,
/turf/open/floor/mineral/titanium/blue,
/area/shuttle/supply)
"h" = (
/obj/structure/window/reinforced{
	dir = 1
	},
/obj/structure/window/plasma/reinforced{
	dir = 8
	},
/obj/structure/window/plasma/reinforced{
	dir = 4
	},
/obj/machinery/atmospherics/components/binary/pump{
	dir = 1;
	name = "Микс в Дистрибуцию";
	on = 1
	},
/turf/open/floor/plating/airless{
	initial_gas_mix = "o2=22;n2=82;TEMP=293.15"
	},
/area/shuttle/supply)
"i" = (
/obj/machinery/conveyor{
	dir = 4;
	id = "Cargo_Shuttle_Conveyor";
	name = "Cargo Shuttle conveyor belt"
	},
/obj/effect/decal/cleanable/dirt,
/obj/effect/turf_decal/bot,
/turf/open/floor/mineral/titanium/white,
/area/shuttle/supply)
"j" = (
/obj/machinery/light{
	dir = 1
	},
/obj/effect/turf_decal/stripes/line{
	dir = 1
	},
/turf/open/floor/mineral/titanium/blue,
/area/shuttle/supply)
"k" = (
/obj/effect/turf_decal/stripes/line{
	dir = 1
	},
/turf/open/floor/mineral/titanium/blue,
/area/shuttle/supply)
"l" = (
/obj/effect/spawner/structure/window/shuttle,
/turf/open/floor/plating,
/area/shuttle/supply)
"m" = (
/obj/structure/window/plasma/reinforced,
/obj/structure/window/plasma/reinforced{
	dir = 8
	},
/obj/structure/window/plasma/reinforced{
	dir = 4
	},
/obj/machinery/atmospherics/components/unary/tank/air{
	dir = 1
	},
/obj/machinery/meter{
	name = "Mixed Air Tank Out"
	},
/turf/open/floor/plating/airless{
	initial_gas_mix = "o2=22;n2=82;TEMP=293.15"
	},
/area/shuttle/supply)
"n" = (
/obj/effect/turf_decal/stripes/line{
	dir = 5
	},
/turf/open/floor/mineral/titanium/blue,
/area/shuttle/supply)
"o" = (
/obj/machinery/computer/cargo{
	dir = 4
	},
/obj/effect/turf_decal/stripes/line{
	dir = 8
	},
/turf/open/floor/mineral/titanium/yellow,
/area/shuttle/supply)
"p" = (
/obj/effect/turf_decal/stripes/line{
	dir = 4
	},
/turf/open/floor/mineral/titanium/blue,
/area/shuttle/supply)
"q" = (
/obj/structure/window/reinforced{
	dir = 1
	},
/obj/structure/shuttle/engine/heater,
/turf/open/floor/plating/airless,
/area/shuttle/supply)
"r" = (
/obj/machinery/light_switch{
	step_x = 0
	},
/turf/closed/wall/mineral/titanium,
/area/shuttle/supply)
"s" = (
/turf/template_noop,
/area/template_noop)
"t" = (
/obj/structure/shuttle/engine/propulsion/burst/left,
/turf/open/floor/plating/airless,
/area/shuttle/supply)
"u" = (
/obj/structure/shuttle/engine/propulsion,
/turf/open/floor/plating/airless,
/area/shuttle/supply)
"v" = (
/obj/structure/shuttle/engine/propulsion/burst/right,
/turf/open/floor/plating/airless,
/area/shuttle/supply)
"w" = (
/obj/machinery/conveyor{
	dir = 4;
	id = "Cargo_Shuttle_Conveyor";
	name = "Cargo Shuttle conveyor belt"
	},
/obj/effect/decal/cleanable/dirt,
/obj/effect/turf_decal/bot,
/turf/open/floor/mineral/titanium/blue,
/area/shuttle/supply)
"x" = (
/obj/machinery/conveyor{
	dir = 4;
	id = "Cargo_Shuttle_Conveyor";
	name = "Cargo Shuttle conveyor belt"
	},
/obj/effect/turf_decal/bot,
/turf/open/floor/mineral/titanium/blue,
/area/shuttle/supply)
"y" = (
/obj/machinery/conveyor{
	dir = 4;
	id = "Cargo_Shuttle_Conveyor";
	name = "Cargo Shuttle conveyor belt"
	},
/obj/effect/turf_decal/delivery,
/turf/open/floor/mineral/titanium,
/area/shuttle/supply)
"z" = (
/obj/machinery/conveyor{
	dir = 4;
	id = "QMLoad2"
	},
/obj/machinery/door/poddoor{
	id = "QMLoaddoor2";
	name = "supply dock loading door"
	},
/obj/effect/decal/cleanable/dirt,
/turf/open/floor/mineral/titanium,
/area/shuttle/supply)
"A" = (
/obj/machinery/conveyor{
	dir = 1;
	id = "Cargo_Shuttle_Conveyor";
	name = "Cargo Shuttle conveyor belt"
	},
/obj/effect/turf_decal/stripes/line{
	dir = 8
	},
/obj/effect/turf_decal/bot,
/turf/open/floor/mineral/titanium/blue,
/area/shuttle/supply)
"B" = (
/obj/effect/decal/cleanable/dirt,
/turf/open/floor/mineral/titanium/white,
/area/shuttle/supply)
"C" = (
/obj/effect/turf_decal/stripes/line{
	dir = 4
	},
/turf/open/floor/mineral/titanium,
/area/shuttle/supply)
"D" = (
/obj/machinery/door/airlock/titanium{
	name = "Supply Shuttle Airlock";
	req_access_txt = "31"
	},
/obj/effect/decal/cleanable/dirt,
/turf/open/floor/mineral/titanium,
/area/shuttle/supply)
"E" = (
/obj/machinery/light{
	dir = 8
	},
/obj/machinery/conveyor{
	dir = 1;
	id = "Cargo_Shuttle_Conveyor";
	name = "Cargo Shuttle conveyor belt"
	},
/obj/effect/turf_decal/stripes/line{
	dir = 8
	},
/obj/effect/decal/cleanable/dirt,
/obj/effect/turf_decal/bot,
/turf/open/floor/mineral/titanium/blue,
/area/shuttle/supply)
"F" = (
/obj/machinery/status_display/evac,
/turf/closed/wall/mineral/titanium,
/area/shuttle/supply)
"G" = (
/obj/machinery/button/door{
	id = "QMLoaddoor2";
	name = "Loading Doors";
	pixel_x = 24;
	pixel_y = 8
	},
/obj/machinery/button/door{
	id = "QMLoaddoor";
	name = "Loading Doors";
	pixel_x = 24;
	pixel_y = -8
	},
/obj/machinery/light{
	dir = 4
	},
/obj/machinery/conveyor_switch/oneway{
	dir = 8;
	id = "Cargo_Shuttle_Conveyor"
	},
/obj/effect/turf_decal/bot,
/turf/open/floor/mineral/titanium/purple,
/area/shuttle/supply)
"H" = (
/turf/open/floor/mineral/titanium/white,
/area/shuttle/supply)
"I" = (
/obj/machinery/status_display/ai,
/turf/closed/wall/mineral/titanium,
/area/shuttle/supply)
"J" = (
/obj/effect/turf_decal/stripes/line{
	dir = 4
	},
/obj/effect/decal/cleanable/dirt,
/turf/open/floor/mineral/titanium,
/area/shuttle/supply)
"K" = (
/obj/machinery/door/airlock/titanium{
	name = "Supply Shuttle Airlock";
	req_access_txt = "31"
	},
/obj/docking_port/mobile/supply,
/obj/effect/decal/cleanable/dirt,
/turf/open/floor/mineral/titanium,
/area/shuttle/supply)
"L" = (
/obj/effect/turf_decal/stripes/line{
	dir = 8
	},
/turf/open/floor/mineral/titanium/blue,
/area/shuttle/supply)
"M" = (
/obj/effect/turf_decal/stripes/line{
	dir = 10
	},
/turf/open/floor/mineral/titanium/blue,
/area/shuttle/supply)
"N" = (
/obj/effect/turf_decal/stripes/line,
/turf/open/floor/mineral/titanium/blue,
/area/shuttle/supply)
"O" = (
/obj/machinery/conveyor{
	dir = 9;
	id = "Cargo_Shuttle_Conveyor";
	movedir = 1;
	name = "Cargo Shuttle conveyor belt"
	},
/obj/effect/turf_decal/stripes/line{
	dir = 8
	},
/obj/effect/turf_decal/bot,
/turf/open/floor/mineral/titanium/blue,
/area/shuttle/supply)
"P" = (
/obj/effect/turf_decal/stripes/line{
	dir = 6
	},
/turf/open/floor/mineral/titanium/blue,
/area/shuttle/supply)
"Q" = (
/obj/machinery/conveyor{
	dir = 8;
	id = "Cargo_Shuttle_Conveyor";
	name = "Cargo Shuttle conveyor belt"
	},
/obj/effect/turf_decal/bot,
/turf/open/floor/mineral/titanium/blue,
/area/shuttle/supply)
"R" = (
/obj/machinery/conveyor{
	dir = 8;
	id = "Cargo_Shuttle_Conveyor";
	name = "Cargo Shuttle conveyor belt"
	},
/obj/effect/turf_decal/delivery,
/turf/open/floor/mineral/titanium,
/area/shuttle/supply)
"S" = (
/obj/machinery/conveyor{
	dir = 8;
	id = "QMLoad"
	},
/obj/machinery/door/poddoor{
	id = "QMLoaddoor";
	name = "supply dock loading door"
	},
/obj/effect/decal/cleanable/dirt,
/turf/open/floor/mineral/titanium,
/area/shuttle/supply)
"T" = (
/obj/structure/window/plasma/reinforced,
/obj/machinery/atmospherics/components/unary/passive_vent,
/obj/machinery/light/small,
/obj/effect/turf_decal/stripes/line,
/obj/effect/turf_decal/bot,
/turf/open/floor/mineral/titanium/purple,
/area/shuttle/supply)

(1,1,1) = {"
b
l
r
b
b
b
b
b
b
l
b
s
"}
(2,1,1) = {"
l
a
o
g
A
E
A
O
L
M
b
t
"}
(3,1,1) = {"
l
d
e
i
B
H
f
Q
c
N
q
u
"}
(4,1,1) = {"
l
j
f
w
c
B
c
Q
f
T
h
m
"}
(5,1,1) = {"
I
k
f
x
c
B
c
Q
f
N
q
u
"}
(6,1,1) = {"
F
n
p
y
C
G
J
R
p
P
b
v
"}
(7,1,1) = {"
b
l
b
z
D
r
K
S
b
l
b
s
"}
